11111111111111111111111
1CCCC0C00C0000000000001
100CPC00C00000000000001
1000C00CE00000000000001
100110C0CC0000000000001
1C1010000C0000000000001
11111111111111111111111